################################################################
################################################################
################################################################
####....###.#################################........###########
###.....###..#.######.##..##..##########.#####........##########
###.....###.....##.............###.##......##..........#####.###
###.....###....................###......................########
###.....###....................###......................########
###.....#####..................###.....................#########
###.....############...........###......................########
###.....############...........###......................########
###.....############...........###.......................#######
####....####....####...........###.........................#####
#####...###......###............##.........................#####
#####...###......###.......................................#####
####....###......###.......................................#####
####.......................................................#####
####........................................................####
###.................................#........................###
###................................##.......................####
###................................###.......................###
###.........##############.##....#################...........###
###.........######################################........######
#####.......######################################........######
######......###...................###.....................######
######......###...................###........................###
#####.......###...................###........................###
###.........###........###........###........................###
###.........###........###........###.......###..............###
###...#.....###........###..................###..............###
###..##.....###........###..................###..............###
########....###........###..................###.............####
################################################################
################################################################
################################################################
################################################################