################
#.r.#p.........#
#...#..........#
#...#..........#
#...#..........#
#...#..........#
#..............#
#..............#
################