################################################################
################################################################
################################################################
#####.....####................###..................###.....#####
####.......##................###...................####.....####
###........##................###....................###......###
###.......###.................###........#..........###......###
###.......##..................###......####........####......###
###.......##..................###.....####.........###......####
###.......##........##........###......##.........####.....#####
###.......##.........##......###.......###........###......#####
###.......####.......###.....###........#........###......######
####.......#######....#.....###..................###......######
######......................###..................###......######
#######......................#.....#...........#####......######
########..#....#..................###.........#####......###.###
####.....##...###.....#...........####........###.........#..###
###.....###....###...###...........##........####............###
###....###......#....###....................#####............###
####..###............###...#...............######.....#......###
#########.....#.....####..###...............#####....###.....###
########.....###....###..#####................###...#####....###
####..........###...###...###................####....###.....###
###............###..###....#.................###......#......###
###.....#...........###.......#.............###..............###
###....###..........####.....###...........####..............###
###...#####..........###......###..........####..............###
###....###...........###.......###..###.....##........#......###
###.....#............###.......############..........###.....###
###..................###........#########.####.......###.....###
###.........#.......###.........####...#..#####.......#......###
####.......###......###..........#..........####....#...#...####
#####.....#####....####.......................###..###.###.#####
################################################################
################################################################
################################################################
