########################
#......................#
#.###..##..#...#.#.#...#
#.###..##..##....#.#...#
#.###......###.....#...#
#......................#
#.##.##................#
#.#...#...p............#
#......................#
#.#...#................#
#.##.##................#
#......................#
#......................#
#......................#
########################